#############################################################################################################################################
#...#.#.....#.......#.......#...#.........#...#...........#.....#.#.......#.......#.....#...#.......#...#.#...............#...#.....#...#..E#
#.#.#.#.#.#.#.#.###.#.#.#####.#.#.#.#####.#.#.#.###.#####.###.#.#.#.#.#.#.#.###.#.#.###.#.###.#####.#.#.#.#.#.#.#########.#.#.#.###.#.###.#.#
#.#...#...#...#...#.#.#.......#...#.....#...#.#.#.#.#.........#...#.#...#.......#.#...#.#.#...#.....#.#...#...#.#.#.....#.................#.#
#.#.#.###.#######.###.#################.#.#####.#.#.#.###########.#.###.#.#######.###.#.#.#.#.#.#.###.#.#####.#.#.#.#.#######.#.#.#####.###.#
#.#.#...#...#...#.....#...............#.#.#...#...#.#.#.........#.#.#...#.......#...#.#.#.#.#.......#.#.#.....#.#.#...................#.#...#
#.#.#.###.#.#.#.#######.#######.###.#.#.###.#.###.#.###.#######.###.#.#.###.###.###.#.#.#.#.#####.#.#.###.###.#.#.#.#######.#####.#.#.#.#.#.#
#.#...#.....#.#.........#.....#...#.#.#...#.#.....#.....#.....#.....#.......#...#.#...#.#.#...#.....#.............#.#.#...#.....#.#.#.......#
#.#.###.#####.#####.###.#.###.#####.#.###.#.#################.#.#######.#####.###.#####.#.###.###.#.#.#.###.#.#.#.#.#.#.#.#####.#.#.#.#.#.###
#.#.....#.........#.....#.#.#.......#...#...#.......................#.....#...#.......#.#...#.....#.#.......#.#.#.....#.#...#...#...#.#.#...#
#.#.#########.###.#.###.#.#.###########.#####.###.#################.###.#.#.###.#######.###.#####.#.###.#####.#.#######.###.#.#######.#####.#
#.#.#...#...#...#...#...#.#...#.......#...#...#.....#...#.........#...#.#.#.#...#.............#...#...#.....................#.......#.......#
#.#.#.#.#.#.#########.#.#.#.#.#.###.#####.###.#.###.#.#.#.#######.###.#.#.#.#.#.#.#############.#.###.#.#.###.#.#.#########.#.###.#.#######.#
#.#.#.....#...#.......#...#.#...#...#.....#...#.#.....#...#...#.....#.....#.#.#.#.#.....#.......#...#.#.............#...#...#.#.#.#.#.....#.#
#.#.#.#######.#.#####.#.#####.###.#.#.#####.###.#.#########.#.#.#######.###.#.#.#.###.#.#.#######.###.#.#.#######.#.#.###.###.#.#.#.###.#.#.#
#...#.......#...#.....#.....#...#.#.#.....#...#.#.#...#...#.#.#.........#...#.#.#.#...#.#.....#.#...#.#.#.........#...#...#.................#
#.#########.#####.#.#.#.###.#####.#######.###.#.###.#.#.#.#.#.#.#########.###.###.#.###.#####.#.#.#.#.#.#########.###.#.###.###.#.#######.###
#.#...#.....#...#.#.#...#.#.#...#.......#...........#...#...#.#...#.....#.#.....#.#.#.....#...#.#.#.......#.....#.......#...#.............#.#
#.#.#.#.#####.###.#.#####.#.#.#.#######.#######.#.###########.###.#.###.#.#####.#.#.#.#####.###.#.#######.###.#########.#.###.#####.#.###.#.#
#...#...#...#.....#.#.....#...#.......#.....#...#...........#...#...#.#.#.....#...#.#.#.....#...#.#.....#.#.............#.....#...#.#...#...#
#.#######.#.#.#####.#.#.#####.#.#####.#####.#.###.#########.###.#####.#.#####.#.###.#.#.#####.###.#.###.#.#.#.#.#############.#.#.#.#.#.#.#.#
#.#.......#.#.....#.#.#.#.....#...#.#.......#...#.#.......#...#.#.....#...#.#.#...#.#.#...#...#.......#.#...#.#.......#...#...#.#...#.#...#.#
###.#######.#######.#.#.#.#####.#.#.#######.###.#.#.#.###.###.#.#.###.###.#.#.###.#.#####.#.###.###.#.#.#############.###.#.###.###.#.###.#.#
#...#.....#.....#...#.#.#.....#.#.#...#...#...#.#.#.#...#.#...#...#.#...#.....#.....#.....#...#.....#.#.#...#...#.....#...#.#...#...#...#...#
#.#####.#######.#.#.#.#######.#.#.#.#.#.#.#.###.#.###.#.###.#.#.###.#.###.###.#######.#####.#.###.#.#.#.#.#.#.#.#.#####.###.#.###.#####.###.#
#.#...#.....#...#...#.......#.#.#.#.#.#.#...#...#...#.#...#.#...#...#.....#...........#.....#.#...#.#.#...#...#.#...#...#...#...#.......#...#
#.#.#.###.###.###.#.#.#####.#.#.#.#.#.#.#####.#.###.#.###.#.#.###.#.#######.###.#############.#.#####.#########.#.#.#.#.#.#####.#####.###.###
#.#.#...#...#...#.#.#.#...#...#.#.#.#.#...........#.#...#...#...#.#...#...#...#...#.....#...#.#...#...#.#.....#.#.#.#.#...#...#...#...#...#.#
#.#.###.#.#.###.#.#.###.#.#.#.#.#.###.###.###.#####.###.#######.#.#####.#.###.###.#.###.#.#.#.###.#.###.#.#.#.#.###.#.#######.###.#####.###.#
#.#.#...#.#...#.#.#...#.#.#.....#...#.....#...#.....#.#...#...#.#.#.....#.....#...#.#.#...#...#...#.#.....#.#.#...#...#.....#...#.......#...#
#.#.#.#####.#.#.#####.#.#.#.#######.#######.###.###.#.###.###.#.#.#.#.#########.#.#.#.#######.#.###.###.###.#####.#.#.#.###.###.#########.#.#
#...#.#.....#.#.....#...#.#.#.....#.......#.#...#.......#...#.....#.#.#.........#...#.......#.#...#...#...#.......#.#...#.......#...#.....#.#
#.###.###.#.###.###.#.#.#.#.#.#.#.#######.#.#.#######.#.###.#######.#.#.#########.#.#.#####.#.###.###.###.###.#####.#.#########.#.#.#####.#.#
#...#.#...#.#.......#.#.#.#.#.#.#.......#.#.#...#...#.#.#...........#.#.....#...#.#.#.#...#.....#...#.......#.......#.#...#.#...#.#.#.....#.#
#####.#.#####.#######.#.#.#.###.#########.#.#.#.#.#.#.#.#.###########.#.#.#.#.#.#.#.###.#.#########.###.###.#.###.#.#.#.#.#.#.###.#.#.#####.#
#...#.#.....#.....#.....#.#...#.........#.......#.#...#.#.#...#.....#.....#.#.#...#.#...#.#.......#...#...#.#...#.#.#.#.#.#.....#.#...#...#.#
#.#.#.#.###.#####.#######.###.#.#.#####.#####.###.###.###.#.#.###.#####.###.#.#####.#.###.#.#####.###.###.#.###.#.#.###.#.#####.#.#####.###.#
#.#...#...#...#...#.......#.#.#...#...#.....#...#...#.#...#.#.#...#.........#.....#.....#.......#...#.#...#.#...#.#.....#...#...#...#.#.....#
#.#########.#.#.###.#####.#.#.###.###.###.#.###.###.###.###.#.#.###.#####.#########.###.###########.#.#.#.#.#.###.#########.#.#####.#.#.#####
#.............#...#.....#...#...#...#...#.....#.........#...#.#.....#.........#...#.......#.......#.#.#...#.#...#...#.......#...............#
#.#.###.#########.###.#.###.###.###.###.#.###.###.#####.#.###.#.#######.#.###.#.#.#########.#####.#.#.#####.###.#####.#.#############.###.#.#
#.#...#.........#...#.#...#...#.#.......#...#...#.........#.#.#...#.....#.....#.#...........#.#...#.#.....#.#...#.......#.......#.....#.#...#
#####.#.#######.###.#.###.#####.###.###.###.###############.#.###.###.###.#####.#############.#.###.#####.#.#.###.###.###.#####.###.#.#.###.#
#.....#...#...#...#.#...#.....#.......#.#...#.........#.....#.......#...#.....................#.#.....#.#...#.#...#...#...#...#.#...#.....#.#
#.#######.#.#.###.#.###.#####.#######.###.###.###.###.#####.#.#####.###.#############.#####.###.#.#.#.#.#####.#.#.#.###.###.#.#.#.#######.#.#
#.#...#...#.#...#...#...#.#...#.....#.#...#...#...#...#.....#.....#.....#...#.........#...#.#...#.#.#...#.#...#.#.#...#.....#.#.#.....#...#.#
#.#.###.###.###.#####.###.#.#.#.#####.#.###.###.###.#.#.###.#####.#####.#.###.#.#####.#.#.#.#.###.#.###.#.#.###.#.#########.###.#.###.#.###.#
#.#...#...#...#.....#.....#.#...#.............#.#...#...#...#.#...#...#...#...#.#...#...#...#.#.#.#...#...#...#.#...........#...#...#.......#
#.#.#.###.###.#.#######.###.###.#.#########.#.#.#.#.#.###.#.#.#.###.#####.#.###.#.#.#########.#.#.###.#######.#.#############.#####.###.#####
#.#.#...#...#.#.........#...#...#.#.......#...#...#.#...#.#.#.#.#.....#...#...#...#.#.......#.#.....#...#...#.#.........#.....#.....#.......#
#.#.#.#####.#.#######.###.#######.#.#####.###.###.#.###.#.#.#.#.#####.#.#####.#####.#.#####.#.#.###.###.#.#.#.###########.#####.#####.#.###.#
#.#.............#...#.#...........#.#.....#...#...#...#.#...#.#.....#.#.#...#...#.#...#...#...#...#.#.#.#.#.#.#.......#...#...#.#.........#.#
#.###.#.#####.###.#.###.###.#######.#.#######.#.#####.#.#.###.#####.#.#.#.#####.#.###.###.#######.#.#.#.#.#.#.#.#####.#.###.#.#.#.###.#.#.#.#
#...#...#...#.#...#...#.#...#.......#...#...#.#.....#.#.#.........#.......#.....#.#...........#...#...#...#...#...#.#...#...#.#.#...#...#.#.#
#.#.#.###.#.###.###.#.#.#.###.#########.#.#.###.###.#.#.###########.#####.#.###.#.#.#.#######.#.#####.###########.#.#######.#.#.#######.#.#.#
#.#.............#.....#.#.....#.......#...#...#.#...#...#...#.....#.....#.#.#...#...#.....#...#.#.....#...#...............#.#.#.......#.#...#
#.#.#.#.###.#.###.#####.#.#.###.#####.#######.###.#.#####.#.#.###.#####.###.###.#.#######.#.###.#.#####.#.#.###########.#.###.#######.#.###.#
#.#.#...#...#.#.#.#.......#.#...#.......#...#.....#.#...#.#...#.#.#...#.#...#...#.......#.#.....#.......#.#...#.......#.#.....#.....#.......#
#.#.#.###.###.#.#.#####.###.#.###.#.###.#.#######.###.#.#.#####.#.#.#.#.#.###.###.#####.#.#############.#.#.#.#.#.###.#.#.#####.#.#####.#.#.#
#.#...#.......#.#.#...#.....#.#...#...#.#.........#...#...#.....#...#...#.#.......#...#.#...#...........#.#.#.#.#.#...#.#.#.................#
#.###.#########.#.#.#.#####.#.#.###.###.#.#########.###########.#.#####.#.#.#######.#.#.###.#.#######.###.###.#.#.#.###.###.#######.#.#.#####
#.......#.......#...#.....#.#.#.#...#...#...#...#...#...........#.....#.#.#.#.......#...#.#...#.....#...#.....#.#.#...#...#.................#
#.#.#.#.###.#.#######.###.###.#.#.###.#####.#.###.###.#########.#.#####.#.#.#.#.#######.#.#####.#.#.###.#########.#.#.###.#.###.#.#########.#
#.#...#.....#.......#...#.....#.#.....#.......#...#...#...........#.....#.#.#.#.#.......#.........#...#...........#.#.....#.#...#.......#...#
#.###.###.#.#####.#.#.#.#######.#######.#######.###.###.###########.#####.#.###.#####.###.#########.###########.###.#####.#.#.#######.#.#.###
#...#.#...#.#...#.#.#.#.......#...#.....#.....#.#...#...........#.......#.#...#.#...#.....#.......#.#...........#.......#.#.#...#...#.#.#.#.#
###.#.#.###.#.###.#.#####.#######.#######.###.#.#.#.#########.###.#######.###.#.#.#.#####.#.#####.#.#.###############.###.#.###.###.#.###.#.#
#.#...............#.#...#.......#.......#...#...#.#...#.....#.....#.#...#...#...#.#...#.#.#...#.#.#.#.#.....#.......#.#...#...#...#.#...#...#
#.#.#.###.#.###.###.#.#.#.###.#.#######.###.###.#.###.#.###.#.#####.#.#.###.#####.###.#.#.###.#.#.###.#.#.#.#####.#.#.#.###.#.#.#.#.###.###.#
#.....#...#.#...#.....#.#.#...#.......#.#...#.....#...#...#.....#...#.#...#.#.....#...#...#...#.#.#...#.........#.#...#...#.#...#...#.#.....#
#######.#####.#########.###.#########.#.#.###.#####.###.#.#####.#.###.###.#.#.#####.###.###.###.#.#.#####.#####.#.###.###.#.###.###.#.#######
#.....#.#.....#.....#.#.....#.....#...#...#...#.....#...#.....#...#...#...#.......#.#.....#.#.....#.#.....#...#.#...#...#...#.#.#...#...#...#
#.#.#.#.#.#####.###.#.###.#.#.###.#########.###.###.#.###.###.###.#.#######.###.###.#.#####.#.#####.#.#####.#.#.###.###.#####.#.#.#####.#.#.#
#...#...#.#...#.#.#.#.....#.#.#.#...#.....#...#.#...#...#.#...#...#.#.........#.#...#.#.....#...#...#.#...#.#.......#...#.....#.#.#...#...#.#
###.#.#.#.#.#.#.#.#.###.###.#.#.###.#.#.###.###.#.###.###.#.###.###.#.#.#.#.#.###.#####.#######.###.#.#.#.#.#.#########.#.#####.#.#.#.#####.#
#...........#.....#...#.....#...#...#.#.....#.....#.......#.#...#...#.#.#.#.#.#...#.....#.......#...#...#.#.#.........#.#.....#.#.#.#.......#
#.#.#.#.#########.###.#.#######.#.###.#######.###.#.###.###.###.#.###.#.###.#.#.#####.###.#######.###.###.#.#####.###.#.###.#.#.#.#.#.#####.#
#.#...#.....#.....#.#.#.#.....#.#.#...#.......#...#.#.#.#.#...#.#...#...#...#...#.....#...#.....#.#.#...#.#.#.......#.#...#.#.#.#...#.......#
#.#.#.#.#.#.###.#.#.#.###.###.#.#.#.###.###.#.#.###.#.#.#.###.#.###.#.#.#.#########.###.###.#.#.#.#.#.#.#.#.#####.#.#.#.#.###.#.#####.#.#####
#.#.......#.....#...#.......#.#.#...#...#.....#...#...#...#.#.......#.#...#.........#...#...#.#...#...#...#...#...#.#.#.#.....#.#.....#.....#
#.#.#.#.###.#######.#########.#.#####.#.#######.###.#####.#.#########.###########.###.#######.#####.###.#####.#.###.#.#.###.###.#.###.#.#.#.#
#.....#.....#.....#...#.....#.....#.#.#.............#.....#.......#.......#.......#.#.#.......#...#.#.#.....#.#.#...#.#...#.#...#...#.#.#.#.#
#.#.#.#.#####.###.#####.###.#####.#.#.#.#.###########.#####.#####.#####.#.#.#######.#.#.#######.#.#.#.#####.#.#.#####.#.###.#.#####.#.#.#.#.#
#...#.#.....#.#.#.#.....#.....#.....#.#.#...#.......#.....#.....#.....#.#.#...#...#.#.#.#.......#.#.#.....#.#...#.....#.#...#.....#...#...#.#
#.#.#.#.###.#.#.#.#.#########.#######.#####.#.#.#.#######.#.#.#.#####.###.#.#.#.#.#.#.#.#.#########.#.###.#.###.#.#####.#.#######.#.#.#####.#
#...#.#.....#.#...#.#.......#.......#.....#...#...#.........#.#.....#...#.#.#...#.#.#.#.#.........#...#.#.#...#.#.#.............#.#.#...#...#
#####.#.#####.#.###.#.#####.#######.#####.#####.###.#########.#.###.###.#.#.#####.#.#.#.#.#######.#####.#.###.#.#.###.###########.#.#.###.###
#...#.#.#...#.#.#.......#...#.#...#...........#...#.......#...#.#...#...#.#...#...#.#...#.#.....#.......#.#.#...#...#.#...........#.#...#.#.#
#.#.#.#.#.###.#.#########.###.#.#.#.#############.###.###.#.###.#.###.###.###.#.###.#####.#.#####.#.#.###.#.#######.###.###########.#.#.#.#.#
#.#...#.#.#...#.#.........#.#...#...#...........#.#...#...#.#...#.........#...#.#...#...#.#...#...#.#...#.#.#.......#...#...........#.#.#.#.#
#.###.#.#.#.###.#.#########.#.#######.#####.###.#.#.#.#.###.#######.#######.###.#.#.#.#.#.###.#.#####.#.#.#.#.#######.#.#.#####.#.#.#.#.#.#.#
#...#.....#.#.....#.....#.............#...#.#...#...#.#.#.#.........#.......#...#.#...#.#.#...#...#...#.....#...#...#.#...#...#...#...#.#...#
#.#.#.#.###.#######.###.#####.#####.###.#.#.#.###.#####.#.#.#######.#######.#.#########.#.#.#####.#.###########.#.#.#.#.#.#.#####.###.#.###.#
#.#.......#.........#.#...#...#.....#...#...#.....#.....#.#.#.....#.#.....#.#.......#...#.#.#.....#.#.........#...#.#.#.#.#...#.....#.#...#.#
#.#######.#.#########.###.#.#.#.#####.###.#######.#.#####.#.#.###.#.#.#.#.#.#######.#.###.#.#.###.#.#.#######.###.#.#.#.#.#.#.#.#####.#.###.#
#.......#.#.......#...#.#.....#.......#...#.....#.#.#.#.....#.#...#.....#.#.#.....#.#.......#...#.#.#.#.....#...#.#.#.#...#.#.#...#...#.....#
###.#####.#######.#.#.#.#####.#.###########.###.###.#.#.#####.###.#######.#.#.###.#.#######.###.###.#.#.#######.###.#.#.#.#.#.#.###.#####.#.#
#...#.....#.......#.#.....#...#.#...........#.#.#...#...#...#...#.........#.#...#.#.#...#...#...#...#.#.......#.....#.#.#.#.#...#...#...#.#.#
#.###.#####.#.#####.#####.#.###.#.###.#######.#.#.#######.#.###.###########.###.#.#.#.#.###.#.#.#.###.#######.#.#####.#.#.#####.#.#####.#.#.#
#...#.#.....#...#...#...#.#.#...#.....#.......#.#.#.......#.....#.#.......#...#.#.#...#...#.#.#.#...#.#.....#...#.....#.#.#...#.#.......#.#.#
###.#.#.###.###.#.#.#.#.###.#.#######.#####.#.#.#.#.#.#.#########.#.###.#####.###.#######.#.#.#.#.###.#.###.#####.#######.#.#.#####.#####.#.#
#.#.#.#.#...#...#.#...#...#.....#...#.#.....#.#.....#.#.#.....#.......#...........#.....#.#...#...#...#.#.#...#...#.....#.#.#.....#.#.....#.#
#.#.#.#.#.###.###########.#####.###.#.#.#####.#######.###.###.#.#################.###.###.###.#####.###.#.###.#.###.###.#.#.#####.#.#.#.###.#
#...#.#.#...#...#.....#...#...#...#.#.#...#.#.......#.#.....#.#.#...#.......#...#...#...#...#.....#...#.#.......#...#...#...#...#...#.#.#...#
#####.#.###.###.#.###.#.###.#.###.#.#.###.#.#######.#.#.#####.#.#.#.#.#####.#.#.###.###.###.#####.###.#.###.#####.#.###.#.###.#.#####.###.###
#.....#...#...#.#...#...#...#.#.#.#.#.....#.......#.#...#.#...#...#.#.#.....#.#...........#.#...#...#.#...#.......#...#.#.#...#.....#...#.#.#
#.#######.#.###.###.#####.###.#.#.#.###########.#.#.#.###.#.#######.#.#.#################.#.#.#.#####.###.#.#########.#.#.#.#####.#####.#.#.#
#.......#.#.........#.....#...#.......#.......#.#.#.#.....#.....#...#.#.#.............#...#...#.....#.....#.#.....#...#.#...#.....#.....#.#.#
#.#####.#.###########.#.#.#.#####.#####.#.###.#.#.#.#######.###.#####.#.#.###########.#.#######.###.#.#####.#.###.#.###.#####.#####.#####.#.#
#.#...#.#.......#.....#...#.....#.#.....#...#.#.#.#...#...#...#.#.....#.#.#.......#...#...#...#.#...#...#...#.#...#...#...#.......#...#.....#
#.#.#.#.#######.#.#############.###.#######.#.#.#.###.#.#.#####.#.#####.#.#.#.###.#.###.###.#.###.###.#.#####.#.#####.###.###########.#.###.#
#...#.#...#.....#.....#.......#.....#.......#.......#...#.#.....#.#...#.....#...#.#...#.#...#.....#.....#.....#.#...#.#.........#.....#...#.#
#####.###.###.#######.#.###.#.#######.###.#######.#.#####.#.#####.#.###.#######.#.###.#.#.###########.###.#####.#.#.#.#########.#.#.#.###.#.#
#...#...#...#.#.....#.#.#...#...#.....#...#...#...#.#...#.#.#.....#.............#...#.#.#...........#.....#...#.....#.....#.....#...#.#.#...#
#.#.###.###.###.###.#.###.#####.#.#####.#.#.#.#.#.###.#.#.#.###.###.#####.###########.#############.#########.#####.#.#.#.#.#.#.###.#.#.###.#
#.#...#.#.#.......#.#.....#.....#.....#.#.#.#...#...#.#.#...#...#.....#.#.#.......#...#.......#.....#.............#.#...#.#.#...#...#.....#.#
#.#####.#.#######.#.#######.#####.###.#.#.#.#######.#.#.#####.#######.#.#.#.#####.#.###.#####.#.#####.#####.#######.#.#.#.#.#.#.#.#.#####.#.#
#.......#...#...#.#.......#.....#.#.....#.#...........#.............#...#.....#.#...#.#...#...#.....#.....#.#...#...#...#.#.#.#.#.#.......#.#
#.#######.#.#.#.#####.#.#######.#.#.#.#.#########.#####.#.#####.###.#.#######.#.#####.#.#.#.###.###.#.###.###.#.#.#######.#.#.#.#.#.#######.#
#.#.......#.#.#.....#.......#.....#...#.........#.#.#...#.#.........#.......#.#.....#...#.#.#.....#.#...#.....#.#.#.......#.#.....#.#...#...#
#.#.#######.#.#####.#######.#.###.#.#########.#.#.#.#.###.#.###########.###.#.#.###.#####.#.#######.#.#########.#.#.#######.#####.#.#.###.###
#.#.......#.#.#.#...#...#...#...#.#.....#.....#.#...#.#.....#...........#.#.#...#.......#.#...#.....#.#.......#.#...#...#...#.....#...#...#.#
#.#########.#.#.#.###.#.#.#####.###.###.#.#.#.#####.#.#.#####.#########.#.#.###########.#.###.#.#####.#.#####.#.#####.###.###.#####.###.###.#
#.#.........#.#.#...#.#.#.#...#...#.....#.#...#.....#.#.....#.#...........#.........#.#.#.#.#...#...#.#.....#...#...........#.#...#.....#...#
#.#.#######.#.#.###.#.#.#.#.#.###.###.#.#.#####.#####.#.###.#.#.#########.#########.#.#.#.#.#####.###.#####.###.#.###.#####.#.#.#.#.#####.#.#
#...#...#...#.#.......#.#.#.#.....#...#.#.....#...#...#.#.#.#.#.........#...#.......#...#.#.#.........#...#...#...#...#...#...#.#...#.....#.#
#####.#.#.###.#.#######.#.#.#######.###.#####.#.#.#.###.#.#.#.#####.#######.#.#######.###.#.#.#########.#.###.###.#.###.#.#.#.#.###.#.#####.#
#.#...#.#.#...#.#...#.#...#.#...#.....#.....#.#.#.......................#...#.#...#...#...#...#.........#...#.....#.#...#.#...#...#...#...#.#
#.#.###.#.#.#####.#.#.###.#.#.#.#####.###.#.#.#.#.#.#.###.#####.#.###.#.#.###.#.###.###.#####.#.###.#######.#.###.#.#.###.#######.#.###.###.#
#.#...#...#.#.....#.#...#.#...#...#...#.#.....................#.....#.#.#...#.#.#...#...#...#...#...#...#...#.......#.#.#.........#...#.#...#
#.###.#.###.#.#####.#.###.#######.#.###.#.###.###.#.###.#.###.#######.#.###.#.#.#.###.###.#.#####.###.#.#.#######.#.#.#.#######.###.#.#.#.###
#...#...#...#.#.#...#...#.......#.#.....#.......#.#...#...#...................#.....#...#.#.............................#.........#...#.#...#
###.#.#.#.###.#.#.#####.#######.#.#########.###.#.###.#####.###.###.#####.#.#.###.#.###.#.#########.#.#####.#####.#.###.###.#####.#.###.###.#
#...#.#.#.....#.#.....#.....#...#.....#...#.#...#.#.......#...#.#...#...#.#.#.....#.....#.#.....#.....................#...#.#...#...#.....#.#
#.###.#.#######.#####.#####.#.#######.#.#.#.#####.#######.###.#.###.#.#.#.#.#####.#######.#.###.#.#.###.#####.#.#.###.###.#.###.#####.###.#.#
#.#...#...........#.#.....#.#.#...#...#.#.#...#...#.....#...#.#...#...#.#...#.....................#...#...#...#.....#.#...#...#.....#.#.#...#
#.#.###.#####.###.#.#####.#.#.#.#.#.###.#.###.#.###.###.#####.###.#.###.###.#.###.#.#.#.#.###.#.#.###.###.###.###.###.#.###.#.#.###.#.#.#####
#.#.....#.......#.....#.#.....#.#.#.#...#.....#.#...#.#.....#...#.#.#.#.#...#.....#...#.#...#.#.#.#.........................#.#...#.#...#...#
#.#######.#.#.#######.#.#.#####.#.#.###.#####.#.#.###.#####.###.#.#.#.#.#.#####.#.#####.###.#.#.#.#.###.###.#####.#######.###.#.#.#####.###.#
#S........#.............#.......#.......#.....#...........#.......#...#.........#.....#.......#...#.......#...................#.#...........#
#############################################################################################################################################